"a" = (/obj/effect/turf_decal/stripes/line{dir = 9},/obj/structure/ore_box,/turf/open/floor/plating,/area/shuttle/auxillary_base)
"b" = (/obj/effect/turf_decal/stripes/line{dir = 1},/turf/open/floor/plating/airless,/area/shuttle/auxillary_base)
"c" = (/obj/effect/turf_decal/stripes/line{dir = 1},/turf/open/floor/plating,/area/shuttle/auxillary_base)
"d" = (/obj/effect/turf_decal/stripes/line{dir = 5},/turf/open/floor/plating,/area/shuttle/auxillary_base)
"e" = (/obj/effect/turf_decal/stripes/line{dir = 8},/turf/open/floor/plating/airless,/area/shuttle/auxillary_base)
"f" = (/turf/open/floor/plating,/area/shuttle/auxillary_base)
"g" = (/obj/effect/turf_decal/stripes/line{dir = 4},/turf/open/floor/plating/airless,/area/shuttle/auxillary_base)
"h" = (/obj/effect/turf_decal/stripes/line{dir = 8},/turf/open/floor/plating,/area/shuttle/auxillary_base)
"i" = (/obj/machinery/camera{dir = 1; network = list("auxbase")},/obj/structure/mining_shuttle_beacon,/turf/open/floor/plating,/area/shuttle/auxillary_base)
"j" = (/obj/effect/turf_decal/stripes/line{dir = 4},/turf/open/floor/plating,/area/shuttle/auxillary_base)
"k" = (/obj/machinery/light{dir = 4},/turf/open/floor/plating,/area/shuttle/auxillary_base)
"l" = (/obj/docking_port/mobile/auxillary_base{dheight = 4; dir = 2; dwidth = 4; height = 9; width = 9},/obj/machinery/bluespace_beacon,/obj/machinery/computer/auxillary_base,/turf/closed/wall,/area/shuttle/auxillary_base)
"m" = (/obj/machinery/light{dir = 8},/turf/open/floor/plating,/area/shuttle/auxillary_base)
"n" = (/obj/machinery/portable_atmospherics/canister/air,/obj/effect/turf_decal/stripes/line{dir = 10},/turf/open/floor/plating,/area/shuttle/auxillary_base)
"o" = (/obj/effect/turf_decal/stripes/line,/turf/open/floor/plating,/area/shuttle/auxillary_base)
"p" = (/obj/effect/turf_decal/stripes/line,/turf/open/floor/plating/airless,/area/shuttle/auxillary_base)
"q" = (/obj/structure/closet/secure_closet/miner/unlocked,/obj/effect/turf_decal/stripes/line{dir = 6},/turf/open/floor/plating,/area/shuttle/auxillary_base)

(1,1,1) = {"
abbcccccd
efffffffg
hfffffffg
hfffifffj
hffklmffj
hfffffffj
hfffffffj
efffffffj
noooooppq
"}
