"a" = (/obj/structure/window/reinforced{dir = 1},/obj/structure/window/reinforced{dir = 8},/obj/structure/chair,/turf/open/floor/plasteel/asteroid,/area/space)
"b" = (/obj/structure/window/reinforced{dir = 1},/obj/structure/chair,/turf/open/floor/plasteel/asteroid,/area/space)
"c" = (/obj/structure/window/reinforced{dir = 1},/obj/structure/window/reinforced{dir = 4},/obj/structure/chair,/turf/open/floor/plasteel/asteroid,/area/space)
"d" = (/obj/structure/window/reinforced{dir = 8},/turf/open/floor/plasteel/asteroid,/area/space)
"e" = (/turf/open/floor/plasteel/asteroid,/area/space)
"f" = (/obj/structure/window/reinforced{dir = 4},/turf/open/floor/plasteel/asteroid,/area/space)
"g" = (/obj/machinery/door/window{base_state = "right"; dir = 4; icon_state = "right"; layer = 3},/turf/open/floor/plasteel/asteroid,/area/space)
"h" = (/obj/structure/window/reinforced{dir = 8},/obj/structure/window/reinforced,/obj/machinery/computer/shuttle/microstation/sselevator{dir = 4},/turf/open/floor/plasteel/asteroid,/area/space)
"i" = (/obj/structure/window/reinforced,/obj/structure/window/reinforced{dir = 4},/obj/docking_port/mobile/ao_elevator,/turf/open/floor/plasteel/asteroid,/area/space)
"j" = (/obj/structure/window/reinforced{dir = 1},/obj/structure/chair,/obj/machinery/light{dir = 1},/turf/open/floor/plasteel/asteroid,/area/space)

(1,1,1) = {"
abjbc
deeef
deeeg
heeei
"}
